NO ./texture/wall1.xpm
         SO ./texture/wall2.xpm
                 WE ./texture/wall3.xpm

F ./texture/floor.xpm
C ./texture/ceil.xpm

EA ./texture/wall4.xpm
        1111111111111111111111111
        1000000000110000000000001
        1011000001110000000000001
        1001000000000000000000001
111111111011000001110000000000001      111111111
100000000011000001110111110111111      100000001
11110111111111011100000010001          100000001
11110111111111011101010010001          100000001
11000000110101010000000010001          110101011
10000000000000000100000000001            11111
10000000000000001101010010001
10N00001110101011111011110001
10110111 1110101 101111010001
11111111 1111111 111111111111


                11111111
                10000001
                10000001
                11111111