NO ./texture/Brick_05.xpm
SO ./texture/Brick_02.xpm
WE ./texture/Brick_03.xpm

F ./texture/Tile_01.xpm
C ./texture/Tile_02.xpm






EA ./texture/Brick_06.xpm

        111111
        100001
        100001
        111111



        1111111111111111111111111
        1000000000110000000000001
        101110000111000N000000001
        1001000000000000000000001
111111111011000001110000000000001      111111111
100000000011000001110111111111111      100000001
11110111111111111100000010001          100000001
11110111111111011101010010001          100000001
11000000110101011100000010001          110101111
10000000000000001100000010001            11111
10000000000000011001010010001
10000001110101011111011110001
10110111 1110101 101111010001
11111111 1111111 111111111111


                11111111
                10000001
                10000001
                11111111

11111
10111
11111
10111
10111
10111
10111
11111



      111
      101
      111
