NO ./textures/path_to_the_north_texture
         SO ./textures/path_to_the_south_texture
                 WE ./textures/path_to_the_west_texture

F 0,0,8
C ./textures/path_to_the_ceiling_texture

EA ./textures/path_to_the_east_texture

        111111
        100001
        100001
        111111



        1111111111111111111111111
        1000000000110000000000001
        1011100001110000000000001
        1001000000000000000000001
111111111011000001110000000000001      111111111
100000000011000001110111111111111      100000001
11110111111111011100000010001          10000 0001
11110111111111011101010010001          100000001
11000000110101011100000010001          110101111
10000000000000001100000010001            11111
100000000000000011001010010001
10000001110101011111011110N0111
10110111 1110101 101111010001
11111111 1111111 111111111111


                11111111
                10000001
                10000001
                11111111

11111
10111
11111
10111
10111
10111
10111
11111



      111
      101
      111