NO ./texture/wall1.xpm
SO ./texture/wall2.xpm
WE ./texture/wall3.xpm
EA ./texture/wall4.xpm
F ./texture/floor.xpm
C ./texture/ceil.xpm

1111111111111111111111111111
1000000000000000000000000001
1000000000000001110000000001
1000000000000001010000000001
1000000000000001110000000001
10000000000000000Q0000000001
1000000000000000000000000001
1000000000000000000000000001
1000000000000000000000000001
1111111111111111111111111111
